111111111111111111111111
100100C00C0000100C00C001
1C00011100100C00C001C001
1C0001100100C00C0011C001
1C000100C00C00001111C001
1C000100C00C00001111C001
1C0000100C00C0001111C001
1C000100C00C00001111C001
1C0001111C00100C00C00001
1C00011100100C00C001C001
1C00011100100C00C001C001
1P0011E000100C00C0000001
111111111111111111111111
