11111
10CE1
10CE1
10CE1
10CE1
10CE1
1PCE1
11111